10 x 20
*************O******
*              R   *
O                  *
*      *************
* *++              *
*                  *
*         H      R *
*          *R      *
*          *       *
******************O*