10 x 20
********************
*   R          R   *
*                  *
*       ************
* +++              *
*                R *
O        H   R   R *
*          *       *
*          *       *
********************